#########################################################
#.......................................................#
#.......................................................#
#.......................................................#
#.........@.............................................#
#.......................................................#
#.......................................................#
#......................................S................#
#.......................................................#
#.........S.................~...........................#
#.......................................................#
#.......................................................#
#.......................................................#
#.......................................................#
#.......................................................#
#.......................................................#
#.......................................................#
#.......................................................#
#.......................................................#
#.......................................................#
#..........................S............................#
#.......................................................#
#########################################################
