#######################################
#~............#.......................#
#............@#.......................#
#.............#............#..........#
#.............#............#..........#
#.......############.......#..........#
#..........................#..........#
#..........................#..........#
#..........................#..........#
#..........................#.....S....#
#..........................#..........#
#.......####################..........#
#.....................................#
#.....................................#
#..................S..................#
#.....................................#
#.....................................#
#.....................................#
#######################################
